1111111111111111111111111111
1000C000000001000000C1000001
1011111111110100001111000101
100000100C010P000001CCC00001
1011100001000000000001111001
1000C1000C11000CC000011C0001
1010000100100011110101010001
1000010101C10000010101010001
1CC000C00000000CCC01000101C1
1000100010100000000000000101
1010100010100CCCCC1000000101
1010100010100000001000001101
1001011101011111110001111C01
10000000000000000E10000001C1
1111111111111111111111111111