1111111111111
111111C111111
1111100011111
1PCCCC1000CE1
1111110011111
111111C111111
1111111111111