111111111111111111111111111
11C0010C0100010001000100011
100100010001000100010001001
1100010001000100C1000100011
100100010001000100010001001
1100010001000E0001000100011
10010001C0010P0100010001001
1100010C0100010001000100C11
100100010001000100010C01CC1
1100010001000100010001CCC11
1C0100010C01000100010001001
111111111111111111111111111