111111111111111111111111111111111111111
1111000000000010000011000000001000000C1
100001101110101111111111101110101101101
1C1111100110100000000000000110010000001
110000000110111111111111111110111111011
101111110110100111111100000000110000001
100000000110001000000101111111000111011
111111110111101011110101101111110000001
10110000011110101100P0E1101011111001111
101101111100011001101110101000000000001
101101111111101101100000101011111111101
101100000000101101111111101010000001001
101111111110100001111111101010111111101
100000000010101100000000001010100000001
100000000C10101011111111101010101110111
111111111110101001010101100010100000001
10000000000010010000000001110011C111001
101111111111111101110111011101101110111
10000000000000000111C111000000000000111
111111111111111111111111111111111111111