111111111111111111111
1P0100010101000100C11
110001000100010011001
100101010001001100011
110001000100010001101
100110010001100110011
110000100100010101001
100101011001000100011
110101000100111001001
100100110011000101011
110011001101010101001
100100010001000100011
110001001101010001101
100101010001000100011
1100010001000100010E1
111111111111111111111